3,3,3,3,3,3,3,3,3,3,3,3,2,2,2,2,2,2,2,2,3,2,2,2,2,2,2,2,2,2,2,2,2,2,2,2,2,3,3,3
3,2,2,2,2,2,2,2,2,2,2,3,11,20,20,20,20,20,20,12,3,11,20,20,20,20,20,20,20,20,20,20,20,20,20,27,24,3,2,3
3,11,20,20,20,20,20,20,20,20,12,3,17,16,16,16,16,16,16,18,3,17,16,16,16,16,16,16,16,16,16,16,19,16,14,6,2,4,22,3
3,17,16,16,16,16,16,16,16,16,18,3,17,16,16,16,16,16,16,18,3,17,16,16,16,16,16,16,16,19,19,14,8,26,10,4,11,20,18,3
3,17,16,16,16,16,16,16,16,16,18,5,17,16,16,16,16,16,16,18,3,17,19,19,16,19,19,19,14,6,2,2,4,16,20,20,16,16,18,3
3,17,16,16,16,16,16,16,16,16,16,27,16,16,19,19,19,16,19,14,3,23,6,25,26,6,2,2,2,4,11,20,20,16,16,16,16,16,18,3
3,17,16,16,16,16,16,16,16,16,14,8,13,14,10,2,25,26,10,2,2,2,4,11,18,3,11,20,20,20,16,16,16,16,16,16,16,16,18,3
3,17,s-16,19,19,19,19,19,14,6,2,2,2,25,11,20,20,16,20,20,20,20,20,16,18,3,17,16,16,16,16,16,16,16,16,16,16,16,18,3
3,13,14,6,3,3,3,3,3,3,21,27,27,27,19,19,19,19,19,19,19,19,19,19,14,3,13,19,19,19,19,19,19,19,19,19,19,19,14,3
2,2,2,2,2,2,2,2,2,2,2,2,2,2,2,2,2,2,2,2,2,2,2,2,2,2,2,2,2,2,2,2,2,2,2,2,2,2,2,2