3,2,2,3,3,2,2,2,3,2,2,2,2,2,2,3,2,2,2,2,2,2,2,2,3,3,3,3,3,3,3,3,2,2,2,2,2,2,2,3
3,11,12,3,3,11,20,12,3,11,27,27,27,27,12,3,11,27,27,27,27,20,27,12,1,2,2,2,2,2,2,3,11,27,27,27,27,27,12,3
3,17,18,1,4,17,16,18,1,2,2,2,2,7,26,3,26,6,2,2,7,26,8,13,27,27,27,27,20,20,12,3,26,6,2,2,2,7,26,3
3,17,16,27,27,16,16,16,27,27,27,27,24,3,26,3,26,3,11,12,3,26,1,2,2,2,2,7,17,16,18,3,26,3,11,27,12,3,26,3
3,17,18,6,7,13,19,18,10,2,2,2,2,3,26,3,26,3,17,18,3,17,27,27,27,27,24,3,17,16,18,3,26,3,23,8,26,3,26,3
3,17,18,1,2,2,7,17,27,27,27,27,24,3,26,3,26,3,13,18,3,26,6,2,2,2,2,4,17,16,18,3,26,1,2,4,26,3,26,3
3,17,16,27,27,24,3,26,3,2,2,2,2,4,26,5,26,1,25,26,5,26,5,11,27,20,27,27,19,19,14,3,13,27,27,27,14,3,26,3
3,17,18,6,2,2,4,26,5,20,20,20,20,20,16,20,19,27,27,19,27,19,27,14,8,26,10,2,2,2,2,2,2,2,2,2,2,4,26,3
3,s-13,14,3,21,27,27,19,27,19,19,19,19,19,19,14,6,3,3,3,3,3,3,3,3,13,27,27,27,27,27,27,27,27,27,27,27,27,14,3
2,2,2,2,2,2,2,2,2,2,2,2,2,2,2,2,2,2,2,2,2,2,2,2,2,2,2,2,2,2,2,2,2,2,2,2,2,2,2,2