11111111111111111111111111111111111111111111111111111111
10000000000000000000000000000000000000000000000000000001
10000000000000000000000000000000000000000000000000000001
10000000000000000000000000000000000000000000000000000001
10000000000000001100000000000000000000000000000000000001
10000000000000001100000000000000000000000000000000000001
10000000000000000000000000000000000000000000000000000001
10000000000000111100000000000000000000000000000000000001
1000000000000000s111111111111111111111111111000000000001
10000000000000000000000000000000000000000000000000000001
10000000000000111120000000000000000000000000000000000001
11111111111111111111111111111111111111111111111111111111