11111111111111111111111111111111111111111111111111111111
10000000000000000000000000000000000000000000000000000001
10000000000000000000000000000000000000000000000000000001
10000000000000000000000000000000000000000000000000000001
10000000000000001100000000000000000000000000000000000001
10000000000000001100000000000000000000000000000000000001
10000000000000000000000000000000000000000000000000000001
10000000000000111100000000000000000000000000000000000001
1000000000000000s100000000000000000000000000000000000001
10000000000000000100000000000000000000000000000000000001
10000000000000111100000000000000000000000000000000000001
11111111111111111111111111111111111111111111111111111111